1111111111111
1001110011111
10000000M00C1
1000011111001
1P0011E000001
1111111111111